*********G*******************
*       *                   *
* ************************* *
* *            *            *
* ****** ****************** *
*              *            *
* ****** ****************** *
* *                         *
* * *********************** *
* *       *         *       *
* ******* ********* *********
*                           *
*  *** ******* ****** ***** *
*            *      *     * *
******S**********************