*******************************
S   *       *   *   * *     * *
*** * ***** * * * * * * *** * *
*   *     *   * * * * * * * * *
* *** ******* * * * * * * * * *
* *   *       *   *   * *   * *
* * ***** ******* * *** *** * *
* *   *   *     * *   *   *   *
* ***** * * *** ***** *** *****
*       *   * *   *   * *   * *
******* ***** *** ***** *** * *
*     * * *     *   *     * * *
* * *** * * * * *** *** *** * *
* * *   * * * *   *   *       *
* * * *** * ********* * *******
* * *     *       *   *     * *
* ********* *** * * *** *** * *
*             * *   *   *   * *
* *********** *********** *** *
* *     *   *   *       *     *
* * *** *** *** ***** ******* *
* *   *   *   *   *         * *
* * * *** * ***** * ********* *
* * * * *   *       *   *     *
* * * * * *** *** *** * * *****
*   *   * *   * *   * *   *   *
*********** *** *** * ******* *
*       *   *     *   *   *   *
* * ***** * * * ******* * * * *
* *       *   *         *   * G 
*******************************